A = (0, 0)
B = (0, 10)
C = (4, 6)
D = (7, 6)
E = (7, 3)
F = (10, 0)
G = (1, 1)
H = (1, 8)
I = (4, 5)
J = (6, 5)
K = (6, 3)
L = (8, 1)

path:ABCDEF
path:GHIJKL
source:(150, 40)