A = (0, 6)
B = (0, 9)
C = (3, 9)
D = (3, 6)
E = (7, 6)
F = (7, 9)
G = (10, 9)
H = (10, 6)
I = (10, 5)
J = (5, 0)
K = (0, 5)
L = (5, 2)
M = (1, 6)
N = (1, 8)
O = (2, 8)
P = (2, 5)
Q = (9, 6)
R = (9, 8)
S = (8, 8)
T = (8, 5)

path:ABCDEFGHIJK
path:MNOPTSRQTLP
source:(350, 430)