A = (2, 10)
B = (5, 1)
C = (7, 3)
D = (7, 7)
E = (5, 9)
F = (3, 9)
G = (1, 7)
H = (1, 3)
I = (3, 1)
J = (6, 10)
K = (8, 8)
L = (8, 2)
M = (6, 0)
N = (2, 0)
O = (0, 2)
P = (0, 8)

path:AJKLMNOP
path:CDEFGHIB
source:(380, 40)