A = (0, 0)
B = (0, 10)
C = (8, 10)
D = (5, 6)
E = (5, 4)
F = (8, 0)
G = (1, 1)
H = (1, 9)
I = (6, 9)
J = (4, 6)
K = (4, 4)
L = (6, 1)

path:ABCDEF
path:GHIJKL
source:(200, 40)