A = (0, 0)
B = (0, 10)
C = (8, 10)
D = (8, 7)
E = (4, 3)
F = (4, 0)
G = (3, 1)
H = (1, 1)
I = (1, 9)
J = (7, 9)
K = (7, 8)
L = (3, 4)

path:ABCDEF
path:GHIJKL
source:(170, 40)