A = (0, 0)
B = (2, 5)
C = (0, 10)
D = (8, 10)
E = (6, 5)
F = (8, 0)
G = (1, 9)
H = (3, 5)
I = (1, 1)
J = (7, 1)
K = (7, 9)
L = (5, 5)

path:ABCDEF
path:IJLKGH
source:(300, 40)